1111111111
1P0001C001
11110101C1
1111000E11
1111111111