111111111111111111111111111
1111111111110000C0000000C11
1C000N00C00N0111N11110N0011
101001010010011111100000111
1010010010101000N0001000011
1N0000000C00C01000000010C11
111111E11110111101100N00011
110P000000C00CNC011111000C1
111111111111111111111111111