11111111111111111111111111111
1C011C1000000000C000111C00001
1000100010N011110100011000101
11000100100110000C10N010101C1
1110001000001C000001001000101
1CC00011111C01110001000100N01
1CC00N00001100000N00C100001C1
1110000110C111111000111111101
1000100110000011100C010000101
1001110000000011101000N0001C1
100PE11111110000001000C100101
10000010000000000011011100101
11000000N0000111C000000000001
11111111111111111111111111111