11111111111111111111111111111
1P00000010000000C0000N0000001
100000C010C000001000000101101
101000101111110010110001C0101
1C10001010000N001011000000001
100000001C00011010C0000000001
10000000101101101000110100001
11100N101011000C1000110100C01
1C111100100000001000000000101
1000N00011001111101100N001101
10001000100010001011000100001
10001000100000N01C00000101111
10000000C00000001000000C00E01
11111111111111111111111111111