111111111111111
11111C111C11111
111110010011111
111100000001111
1110N11011N0111
1C0011101110CN1
11001100E110011
111C000P000C111
110011000110011
1NC0111011100C1
1110N11011N0111
111100000001111
111110010011111
11111C111C11111
111111111111111