11111111111111111111111
11000000000C000111100C1
1C010N01111010001100011
1C0100110000C10N0101011
11000001C00000100101001
111111C01111001C00000N1
1C0001100000N0111110011
10110C11111100011111001
1E110000C11100C011111C1
1P000000011111000N00001
11111110000001100C10101
11000000110001101110101
1C0N0000111C000000000C1
11111111111111111111111
